%%%%%%%%%%%%%%%%%%%%
%G...%..G..G..%...G%
%.%%.%.%%..%%.%.%%.%
%.G.... G GG%......%
%.%.%%.%% %%%.%%.%.%
%.%....% ...%.%..%.%
%.%.%%.% %% %.%.%%.%
%G%..G...P.G..%...G%
%%%%%%%%%%%%%%%%%%%%
